000023333320002112000
000023333320002112000
222222111222222112000
111111111111111112000
111111111111111112000
222222222222222112000
000000000000002112000
000000440000022112200
000004440000021111200
000000000000021111200
000000000000021111200